wadzi - radzi
niechże - panie
piwa - wina
klawesynofonija - gęśli

taki - tak
wam - nań
śmiecha - śmieje
naumartwiał - troszcze

ważnie - bacznie
Dostatek - Ostatek
bogini - Fortuna
także - też

spadnie - snadnie
ten - kto
wczoraj - dopiero
- go

smutno - dziwnie
tymże - tym
umysłem - rozumem
we - w

trzymać - mieć
niepojęte - wieczne
ominie - minie
dozwolenia - przejźrzenia

wszakże - nigdy
weń - tak
smutki - nieszczęście
przetrzymać - wytrzymać

prawdy - szczęście
wprawdzie - też
we - w
oblubieniczki - posagu

marudzę - umiem
żłe - nagle
filary - dary
a - aby

trunki - bogactwa
wały - skały
skruchy - otuchy
nieprzekornej - równej